Bijlage 1 Lijst met afkortingen 
 
AHN – Actuele hoogtebestand Nederland 
AR – Algemene Rekenkamer 
BBT – Bonaire Brandstof Terminal 
BES – Bonaire, Sint Eustatius, Saba 
BNMP - Bonaire National Marine Park 
BZK – Ministerie van Binnenlandse Zaken en Koninkrijksrelaties 
CBS – Centraal Bureau voor de Statistiek 
CN – Caribisch Nederland 
DPRA – Deltaplan voor Ruimtelijke Adaptatie 
EZK – Ministerie van Economische Zaken en Klimaat 
IenW- Ministerie van Infrastructuur en Waterstaat 
IBO – Interdepartementaal beleidsonderzoek 
ICER - Integrale Circulaire Economie Rapportage 
ILT – Inspectie leefomgeving en transport 
IPCC – Intergovernmental Panel on Climate Change 
IPDC - International Panel for Deltas and Coastal Areas 
IVM - Instituut voor milieuvraagstukken 
KEV - Klimaat en Energieverkenning 
KIN – Klimaatonderzoek Initiatief Nederland (KIN) 
KNMI – Koninklijk Meteorologisch instituut 
LNV – Ministerie van Landbouw, Natuur en Visserij 
NAS - Nationale Strategie Klimaatadaptatie  
NIWA – Nederlandse Internationale Waterambitie 
NMBP – Natuur, Milieu en Beleidsplan 
NPCE - Nationaal Programma Circulaire Economie 
NWO – Nederlandse Organisatie voor Wetenschappelijk onderzoek 
OLB - Openbaar Lichaam Bonaire 
PBL - Planbureau voor de leefomgeving 
RCN – Rijksdienst Caribisch Nederland 
RES- Regionale Energiestrategie 
RVO – Rijksdienst voor ondernemend Nederland 
RvS – Raad van State 
STINAPA - Stichting Nationale Parken Bonaire 
VRO – (de minister van) Volkshuisvesting en Ruimtelijke Ordening 
VU – Vrije Universiteit 
WOLBES – Wet Openbare Lichamen Bonaire, Sint Eustatius en Saba 
WSNP- Washington Slagbaai Nationaal Park 
WUR – Wageningen University & Research 
  
   34
