LIJST MET AFKORTINGEN  
ACTPOL - Centraal registratiesysteem voor politie 
AT  - Arrestatieteam 
Atrako - Overval (Papiaments) 
Atrako-team - Team van KPC-, KLPD- en KMar  ter bestrijding van atrako’s op Curaçao 
BC  - Begeleidingscommissie 
BZK  - Ministerie van Binnenlandse Zaken en Koninkrijksrelaties 
BES  - Bonaire, Saba en Sint Eustatius 
BF  - Bon Futuro (gevangenis Curaçao)  
BMS  - Border Management System 
CB analyse - Criminaliteitsbeeldanalyse 
CPT   - Committee for the Prevention of Torture and Inhuman and Degrading Treatment 
DJI  - Dienst Justitiële Inrichtingen       
DJZ  - Dienst Justitiële Zaken (onderdeel Ministerie van Justitie NA)  
FMS  - Foreigner Management System 
GGCT - Gemeenschappelijk Grens Controle Team 
GOG  - Gerechtelijk Opvoedings Gesticht 
GWNA - Gevangeniswezen Nederlandse Antillen 
HRM  - Human Resources Management 
ICT  - Informatie- en communicatie technologie 
IND  - Immigratie- en Naturalisatie Dienst 
JJI  - Justitiële Jeugdinrichting  
KLPD  - Korps Landelijke Politie Diensten 
KMar  - Koninklijke Marechaussee 
KPB  - Korps Politie Bonaire 
KPC  - Korps Politie Curaçao 
KPSM - Korps Politie Sint Maarten 
KPSSS - Korps Politie Sint Maarten, Saba en Sint Eustatius 
KR  - Koninkrijksrelaties 
Land(en) - Curaçao of (en) Sint Maarten na 10-10-‘10 
MSG  - Ministeriële stuurgroep  
NA  - Nederlandse Antillen 
NAF  - Antilliaanse gulden 
NTO  - Nieuwe Toelatingsorganisatie 
OM  - Openbaar Ministerie 
PB  - Pointe Blanche (gevangenis Sint Maarten) 
PG  - Procureur Generaal 
PIOFAH - Personeel, Informatie, Organisatie, Financiën, AO en Huisvesting 
PRIEM - Parket Registratie en Informatie Management Systeem 
PV  - Plan Veiligheid (na 10-10-’10) 
PVNA  - Plan Veiligheid Nederlandse Antillen 
PVNA1 - Eerste Plan Veiligheid Nederlandse Antillen 
PVNA2 - Tweede Plan Veiligheid Nederlandse Antillen 
RIEC  - Regionaal Informatie- en Expertise Centrum 
RGD  - Rijksgebouwendienst 
RST  - Recherche Samenwerkingsteam 
SDKK  - Sentro di Detenshon i Korekshon Kòrsou (gevangenis Curaçao)  
SONA - Stichting Ontwikkelingsgelden Nederlandse Antillen 
SXM  - Sint Maarten 
TO  - Toelatingsorganisatie 
USONA - Uitvoeringsorganisatie van de stichting SONA 
VNA  - Veiligheidsdienst Nederlandse Antillen
