Lijst met afkortingen
BIJLAGE 9: LIJST MET AFKORTINGEN 
AC = Aanmeldcentrum 
ACOTA = Africa Contingency Operations Training and Assis-
tance 
AD = Algemene Dienst 
AE = Aanhoudingseenheid 
AFD = Audit Functie Defensie 
AMB = Air Manoeuvre Brigade 
AMBV = Mijnenbestrijdingsvaartuig van de Alkmaar-klasse 
AMET = Aero Medical Evacuation Team 
AMISOM = African Union Mission in Somalia 
API = Advanced Passenger Information 
AOM = Allied Operations and Missions 
AOCS (NM) = Air Operations Control Station (Nieuw Milligen) 
ATF = Air Task Force 
ATF-ME = Air Taskforce Middle East 
AWACS = Airborne Warning and Control System 
BE = Bijstandseenheid 
BG = Battle Group 
BG = Bedrijfsgroep 
BINUB = Bureau Intégré des Nations Unies au Burundi 
BLOW = Bestuursovereenkomst Landelijke Ontwikkeling 
Windenergie 
BMS = Battlefield Management System 
BTW = Belasting Toegevoegde Waarde 
CARIB = Caribisch Gebied 
CDC = Commando DienstenCentra 
CD&E = Concept Development and Experimentation 
CFK = Chloorfluorkoolstoffen 
CFMCC = Combined Force Maritime Component Command 
CIED = Counter Improvised Explosive Devices 
CIMIC = Civil-military Cooperation 
CIS = Communicatie- en Informatiesystemen 
CKMAR = Commando Koninklijke Marechaussee 
CLAS = Commando Landstrijdkrachten 
CLSK = Commando Luchtstrijdkrachten 
CMH = Centraal Militair Hospitaal 
CODEMO = Commissie Defensie Materieel Ontwikkeling 
COID = Centrale Organisatie Integriteit Defensie 
CONTCO = Contingentscommando 
CS = Combat Support 
CSS = Combat Service Support 
CSTC(A) = Combined Security Transition Command Afghanistan 
CTF = Commander Task Force 
CUP = Capability Upgrade Programme 
CZSK = Commando zeestrijdkrachten 
DBBO = Defensie Beveiligings- en Bewakingsorganisatie 
DBV = Dienst Beveiliging Vastgoed 
DCC = Defensie Cyber Commando 
DCHR = Dienstencentrum Human Resources 
DCIVB = Dienstencentrum IV-beheer 
DCOID = Dienstencentrum Internationale Ondersteuning 
Defensie 
DefCert = Defensie Computer Emergency Response Team 
DDG = Defensie DuikGroep 
Tweede Kamer, vergaderjaar 2014–2015, 34 200 X, nr. 1 140
