Lijst met afkortingen
DDN = Defensie Duurzaamheidsnota 
DGI = Defensiegerelateerde industrie 
DGO = Defensie Gezondheidsorganisatie 
DHC = Defensie Helikopter Commando 
DIS = Defensie Industrie Strategie 
DMO = Defensie Materieel Organisatie 
DMP = Defensie Materieelkeuze Proces 
DPOD = Divisie Personeel en Organisatie Defensie 
DR&D = Defence Research & Development 
DRC = Democratische Republiek Congo 
DSK = Division Schnelle Kräfte 
DTO = Defensie Telematica Organisatie 
DUBO = Duurzaam Bouwen 
DVD = Dienst Vastgoed Defensie 
EATC = European Air Transport Command 
EDA = Europees Defensie Agentschap 
EGF = Europese Gendarmerie Force 
EODD = Explosieven Opruimingsdienst Defensie 
EOV = Elektronische oorlogsvoering 
EPA = Energie Prestatie Adviezen 
ERP = Enterprise Resource Planning 
EU = Europese Unie 
EUAVSEC = European Aviation Security Mission 
EUBAM = EU Border Assistance Mission 
EUFOR = European Force 
EULEX = European Union Rule of Law Mission (Kosovo) 
EUMM = European Union Monitor Mission 
EUNAVFOR = EU Naval Force 
EUPM = European Union Police Mission (Bosnië en Herzego-
vina) 
EUPOL = European Police 
EUSEC = European Security 
EUTM = European Union Training Mission 
EVDB = Europees Veiligheids- en Defensiebeleid 
FBUH = Fysieke bescherming en uitrusting hulpverleners 
FABK = Financieel Administratie en Beheer Kantoor 
FCSS = Fast Combat Support Ship 
FGBADS = Future Ground Based Air Defence System 
FHQ = Field Headquarters 
FINAD = Financiële Administratie 
FNIK = Financiering Nationale Inzet Krijgsmacht 
FMS = Foreign Military Sales 
FPS = Flexibel Personeelssysteem 
FPU = Flexibel Pensioen en Uittreden 
GVKKA = Geïntegreerde Verplichtingen Kas- en Kostenadminis-
tratie 
HGIS = Homogene Groep Internationale Samenwerking 
HLD = High Level Design 
HQ = Headquarter 
HRF(L)HQ = High Readiness Forces (Land) Headquarters 
HRM = Human Resource Management 
IBO = Interdepartementaal Beleidsonderzoek 
ICMS = Intensivering Civiel-Militaire Samenwerking 
IED = Improvised Explosive Devices 
IG = Innovation Game 
IGV = Infanterie Gevechtsvoertuig 
Tweede Kamer, vergaderjaar 2014–2015, 34 200 X, nr. 1 141
