Lijst met afkortingen
ILS = Integrated Logistic Support 
IND = Immigratie- en Naturalisatie Dienst 
INK = Instituut Nederlandse Kwaliteitszorg 
IPU = Integrated Police Unit 
ISAF = International Security Assistance Force 
ISR = Information Storage and Retrieval 
ISTAR = Intelligence Surveillance, Target Acquisition and 
Reconnaissance 
IV = Informatievoorziening 
IV/ICT = Informatievoorziening en Informatie- en communicatie 
technologie 
IVENT = Informatievoorziening en Telematica 
JEF = Joint Expeditionary Force 
JISTARC = Joint Intelligence Surveillance Target Acquisition and 
Reconnaissance Command 
JIVC = Joint IV Commando 
JSCU = Joint Sigint and Cyber Unit 
JSF = Joint Strike Fighter 
JSS = Joint Support Ship 
JTFC = Joint Task Force Counter 
KAF = Kandahar Airfield 
KFOR = Kosovo Force 
KMA = Koninklijke Militaire Academie 
LCF = Luchtverdedigings- en Commandofregat 
LCW = Logistiek Centrum Woensdrecht 
LOKKMAR = Landelijk Opleidings- en Kenniscentrum KMAR 
LOT = Liaison and Observation Team 
LRIP = Low Rate Initial Production 
LSV = Luchtmobiel Speciaal Voertuig 
LTC = Landelijk Tactisch Commando 
LZV = Landelijk Zorgsysteem Veteranen 
MARIN = Maritiem Research Instituut Nederland 
ME = Mobiele eenheid 
MECHBRIG = Gemechaniseerde Brigade 
MFO = Multinational Foce and Observers 
MGGZ = Militair Geestelijke Gezondheidszorg 
MIA = Maatschappelijke Innovatie Agenda 
MILSATCOM = Militaire Satellietcommunicatie 
MINUSMA = Multidimensional Integrated Stabilisation Mission in 
Mali 
MIVD = Militaire Inlichtingen- en Veiligheidsdienst 
MKB = Midden- en Kleinbedrijf 
MoU = Memorandum of Understanding 
MRAT = Medium Range Anti-Tank 
MRC = Militair Revalidatie Centrum 
MTADS = Modernized Target Acquisition and Designation Sight 
NAHEMA = NATO Helicopter Management Agency 
NATO = North Atlantic Treaty Organisation 
NATRES = Nationale Reserve 
NAVO = Noord-Atlantische Verdragsorganisatie 
NBC = Nucleair, Biologisch, Chemisch 
NDMC = Nationale Datalink Management Cel 
NEC = Network Enabled Capabilities 
NFO = Normal Framework Operations 
NGO = Non-Governemental Organisation/Niet-
Gouvernementele Organisatie 
Tweede Kamer, vergaderjaar 2014â€“2015, 34 200 X, nr. 1 142
