Lijst met afkortingen
NH 90 = Navo Helicopter ’90 
NIC = National Intelligence Cell 
NIMCIS = Nieuwe Generatie Mariniers Communicatie- en 
Informatiesysteem 
NIST = National Institute for Standards and Technology 
NLMARFOR = Netherlands Maritime Forces 
NLR = Nationaal Lucht- en Ruimtevaartlaboratorium 
NLTC = Netherlands Liaison Team Centcom 
NRF = NATO Response Force 
NSE = National Support Element 
NSS = Nuclear Security Summit 
NTM-A = NATO Training Mission Afghanistan 
NTM-I = NATO Training Mission Iraq 
NTP = Nationaal Technologie Project 
OD = Operationele doelstelling 
OGRV = Operationele Grondverdediging 
OHQ = Operational Headquarters 
OM = Openbaar Ministerie 
OMLT = Operational Mentoring and Liaison Teams 
OOCL = Operationeel Ondersteuningscommando Land 
OOS = Operatie Ocean Shield 
OPCO = Operationeel Commando 
OVR = Officier Veiligheidsregio 
PAC = Patriot Advanced Capability 
PAM = Project Aanpassing Mijnenbestrijdingscapaciteit 
PMD = Professionaliseren Materieelbeheer Defensie 
POP = Persoonlijk Ontwikkelplan 
PPS = Publiek-Private Samenwerking 
PRT = Provincial Reconstruction Team (Afghanistan) 
PSFD = Production, Sustainment and Follow-on Development 
RAP = Readiness Action Plan 
RCA = République Central Africaine 
RCP = Rafah Crossing Point 
RC(S) = Regional Command (South) 
RDTF = Redeployment Task Force 
R&D = Research and Development 
RGD = Rijksgebouwen Dienst 
RHB = Rijkshoofdboekhouding 
ROC = Regionaal Opleidingscentrum 
RPV = Remotely Piloted Vehicles 
RSM = Resolute Support Mission 
RWT = Rechtspersoon met een Wettelijke Taak 
SAC = Strategic Airlift Command 
SAR = Search and Rescue 
SBIR = Small Business Innovation Research 
SBK = Sociaal Beleidskader 
SFIR = Stabilization Force Iraq 
SLA = Service Level Agreement 
SPEER = Strategic Process and Enterprise Resource Planning 
Enabled Reengineering 
SSD = Security Sector Development 
SSO = Shared Service Organisatie 
SSR = Security Sector Reform 
STANAG = Standardisation Agreement 
STARS = Sensor Technology Applied in Reconfigurable systems 
for Sustainable security 
Tweede Kamer, vergaderjaar 2014–2015, 34 200 X, nr. 1 143
